1111111111111
101Y0000000C1
11000Y00Y0001
1P001E000Y001
1000000000001
10110000000C1
11000Y00Y0001
1111111111111